In Memoriam
An Interactive Fiction by Loquacious Libriform Computing
Release 1 / Serial number 151121 / Inform 7 build 6L38 (I6/v6.33 lib 6/12N) SD

Jones' Memorial Baptist
There is a crowd gathered here, mourning the loss of your wife.

There is a casket at the front of the room.

You can also see a plaque here.

Outside is the parking lot, with your car and some well-deserved tranquility.

>look at wife
You can't see any such thing.

>take wife
You can't see any such thing.

>take casket
Later.

>look at casket
Orante, brown, and very expensive.

In the casket is a deceased woman.

>look at casket
Orante, brown, and very expensive.

In the casket is a deceased woman.

>look at deceased
Beautiful, you're sure. But you can't quite bring yourself to look at her.

* * *

In Memoriam
An Interactive Fiction by Loquacious Libriform Computing
Release 1 / Serial number 151121 / Inform 7 build 6L38 (I6/v6.33 lib 6/12N) SD

Jones' Memorial Baptist
There is a crowd gathered here, mourning the loss of your wife.

There is a casket at the front of the room.

You can also see a plaque here.

Outside is the parking lot, with your car and some well-deserved tranquility.

>ask mysterious figure
What do you want to ask the mysterious figure for?

>a casket
I don't know who "mysterious figure" is.

>look
Jones' Memorial Baptist
There is a crowd gathered here, mourning the loss of your wife.

There is a casket at the front of the room.

Outside is the parking lot, with your car and some well-deserved tranquility.
There is something different about the casket.

>look
Jones' Memorial Baptist
There is a crowd gathered here, mourning the loss of your wife.

There is a casket at the front of the room.

Outside is the parking lot, with your car and some well-deserved tranquility.
There is something different about the casket.

* * *

In Memoriam
An Interactive Fiction by Loquacious Libriform Computing
Release 1 / Serial number 151121 / Inform 7 build 6L38 (I6/v6.33 lib 6/12N) SD

Jones' Memorial Baptist
There is a crowd gathered here, mourning the loss of your wife.

There is a casket at the front of the room.

You can also see a plaque here.

Outside is the parking lot, with your car and some well-deserved tranquility.

>look
Jones' Memorial Baptist
There is a crowd gathered here, mourning the loss of your wife.

There is a casket at the front of the room.

You can also see a plaque here.

Outside is the parking lot, with your car and some well-deserved tranquility.

>look at casket
Orante, brown, and very expensive.

In the casket is a deceased woman.

>look at wife
Beautiful, you're sure. But you can't quite bring yourself to look at her.

>take wife
It's far too late to hold her.

>take casket
Later.

>break casket
Violence isn't the answer to this one.

>attack casket
Violence isn't the answer to this one.

>attack wife
Violence isn't the answer to this one.

* * *

In Memoriam
An Interactive Fiction by Loquacious Libriform Computing
Release 1 / Serial number 151121 / Inform 7 build 6L38 (I6/v6.33 lib 6/12N) SD

Jones' Memorial Baptist
There is a crowd gathered here, mourning the loss of your wife.

There is a casket at the front of the room.

You can also see a plaque here.

Outside is the parking lot, with your car and some well-deserved tranquility.

>look at casket
Orante, brown, and very expensive.

In the casket is a deceased woman.

>look at wife
You see nothing special about your wife.

* * *

>look at casket
Orante, brown, and very expensive.

In the casket is a deceased woman.

>look
Jones' Memorial Baptist
There is a crowd gathered here, mourning the loss of your wife.

There is a casket at the front of the room.

Outside is the parking lot, with your car and some well-deserved tranquility.

>go outside
Outdoors
It's a lovely day outside. Balmy. Partly cloudy. You can hear the birds singing in the distance, as well as the chatter of those standing near the door.

Your Camaro is nearby.

>look
Outdoors
It's a lovely day outside. Balmy. Partly cloudy. You can hear the birds singing in the distance, as well as the chatter of those standing near the door.

Your Camaro is nearby.

>look at casket
You can't see any such thing.

* * *

In Memoriam
An Interactive Fiction by Loquacious Libriform Computing
Release 1 / Serial number 151121 / Inform 7 build 6L38 (I6/v6.33 lib 6/12N) SD

Jones' Memorial Baptist
There is a crowd gathered here, mourning the loss of your wife.

There is a casket at the front of the room.

You can also see a plaque here.

Outside is the parking lot, with your car and some well-deserved tranquility.

>go out
Outdoors
It's a lovely day outside. Balmy. Partly cloudy. You can hear the birds singing in the distance, as well as the chatter of those standing near the door.

Your Camaro is nearby.

>get in car
Looks like a good place to get a quick break from today's events. You might try taking a quick REST here.

(You are now in the car).