Interperter
An Interactive Fiction by a bunch of people
Release 1 / Serial number 151116 / Inform 7 build 6L38 (I6/v6.33 lib 6/12N) SD

Jones' Memorial Baptist
There is a crowd gathered here, mourning the loss of your wife.

There is a casket at the front of the room.

Outside is the parking lot, with your car and some well-deserved tranquility.

>look
Jones' Memorial Baptist
There is a crowd gathered here, mourning the loss of your wife.

There is a casket at the front of the room.

Outside is the parking lot, with your car and some well-deserved tranquility.

* * *

Interperter
An Interactive Fiction by a bunch of people
Release 1 / Serial number 151116 / Inform 7 build 6L38 (I6/v6.33 lib 6/12N) SD

Jones' Memorial Baptist
There is a crowd gathered here, mourning the loss of your wife.

There is a casket at the front of the room.

Outside is the parking lot, with your car and some well-deserved tranquility.

>ask mysterious figure
What do you want to ask the mysterious figure for?

* * *

Interperter
An Interactive Fiction by a bunch of people
Release 1 / Serial number 151116 / Inform 7 build 6L38 (I6/v6.33 lib 6/12N) SD

Jones' Memorial Baptist
There is a crowd gathered here, mourning the loss of your wife.

There is a casket at the front of the room.

Outside is the parking lot, with your car and some well-deserved tranquility.

>look at casket
Orante, brown, and very expensive.

In the casket are a boquet and your wife.

* * *

Interperter
An Interactive Fiction by a bunch of people
Release 1 / Serial number 151116 / Inform 7 build 6L38 (I6/v6.33 lib 6/12N) SD

Jones' Memorial Baptist
There is a crowd gathered here, mourning the loss of your wife.

There is a casket at the front of the room.

Outside is the parking lot, with your car and some well-deserved tranquility.

>look at wife
You can't see any such thing.

* * *

>look at deceased
Beautiful, you're sure. But you can't quite bring yourself to look at her.

>ask mysterious figure
You can't see any such thing.

* * *

Interperter
An Interactive Fiction by a bunch of people
Release 1 / Serial number 151116 / Inform 7 build 6L38 (I6/v6.33 lib 6/12N) SD

Jones' Memorial Baptist
There is a crowd gathered here, mourning the loss of your wife.

There is a casket at the front of the room.

Outside is the parking lot, with your car and some well-deserved tranquility.

>go outside
Outdoors
It's a lovely day outside. Balmy. Partly cloudy. You can hear the birds singing in the distance, as well as the chatter of those standing near the door.

Your Camaro is nearby.

* * *

>get in car
You get into your car.

>rest
Your mind begins to drift back to memories of you and your wife.
You begin to drift off to sleep, but are rudely awakened by a question:
"What time is it?"

Bedroom (in your bed)
Your bedroom, with a lovely king-size bed, silk covers, and plenty of space. 
 Light streams in through small cracks in the blinds.

A small watch lies on your bedside table, along with an empty glass.

You can also see a glass (empty) here.

Your wife lies next to you, groggy but awake.

>check watch
Reads 8:12. You are late.

Your wife glances at the watch at the same time you do. She seems furious. 
"The kids are going to be late for school! Again! Did you not set the alarm? Actually, scratch that - I don't care. Get ready and meet me downstairs."

>gi downstairs
That's not a verb I recognise.

>go downstairs
You can't see any such thing.

>look
Bedroom (in your bed)
Your bedroom, with a lovely king-size bed, silk covers, and plenty of space. 
 Light streams in through small cracks in the blinds.

A small watch lies on your bedside table, along with an empty glass.

You can also see a glass (empty) here.

* * *

Interperter
An Interactive Fiction by a bunch of people
Release 1 / Serial number 151116 / Inform 7 build 6L38 (I6/v6.33 lib 6/12N) SD

Jones' Memorial Baptist
There is a crowd gathered here, mourning the loss of your wife.

There is a casket at the front of the room.

Outside is the parking lot, with your car and some well-deserved tranquility.

>go downstairs
You can't see any such thing.

>actions
Actions listing on.

>go downstairs
You can't see any such thing.

>go
You'll have to say which compass direction to go in.

>go out
[going outside]

Outdoors
It's a lovely day outside. Balmy. Partly cloudy. You can hear the birds singing in the distance, as well as the chatter of those standing near the door.

Your Camaro is nearby.

[going outside - succeeded]

>go in
[going inside]

Jones' Memorial Baptist
There is a crowd gathered here, mourning the loss of your wife.

There is a casket at the front of the room.

Outside is the parking lot, with your car and some well-deserved tranquility.
[going inside - succeeded]

>go car
You can't see any such thing.

>look
[looking]
Jones' Memorial Baptist
There is a crowd gathered here, mourning the loss of your wife.

There is a casket at the front of the room.

Outside is the parking lot, with your car and some well-deserved tranquility.
[looking - succeeded]

>go down
[going down]
You can't go that way.
[going down - failed the can't go that way rule]

* * *

Interperter
An Interactive Fiction by a bunch of people
Release 1 / Serial number 151116 / Inform 7 build 6L38 (I6/v6.33 lib 6/12N) SD

Jones' Memorial Baptist
There is a crowd gathered here, mourning the loss of your wife.

There is a casket at the front of the room.

Outside is the parking lot, with your car and some well-deserved tranquility.

>go out
Outdoors
It's a lovely day outside. Balmy. Partly cloudy. You can hear the birds singing in the distance, as well as the chatter of those standing near the door.

Your Camaro is nearby.

* * *

>rest
Your mind begins to drift back to memories of you and your wife.
You begin to drift off to sleep, but are rudely awakened by a question:
"What time is it?"

Bedroom (in your bed)
Your bedroom, with a lovely king-size bed, silk covers, and plenty of space. 
 Light streams in through small cracks in the blinds.

 The kitchen is downstairs from here.

A small watch lies on your bedside table, along with an empty glass.

You can also see a glass (empty) here.

Your wife lies next to you, groggy but awake.

>go down
Unless you plan on pushing your bed around, you'll ned to GET OUT of bed first.

>get out
You get out of your bed.

Bedroom
Your bedroom, with a lovely king-size bed, silk covers, and plenty of space. 
 Light streams in through small cracks in the blinds.

 The kitchen is downstairs from here.

A small watch lies on your bedside table, along with an empty glass.

You can also see your bed (in which is your wife) and a glass (empty) here.

>go down
Kitchen

>go up
Bedroom
Your bedroom, with a lovely king-size bed, silk covers, and plenty of space. 
 Light streams in through small cracks in the blinds.

 The kitchen is downstairs from here.

A small watch lies on your bedside table, along with an empty glass.

You can also see your bed (in which is your wife) and a glass (empty) here.

>go downstairs
Try going DOWN instead.

>talk to wife
Perhaps you meant to ASK someone about something?

>ask wife about bed
There is no reply.

>check watch
Reads 8:12. You are late.

>get in bed
You get into your bed.

Your wife lies next to you, groggy but awake.

>take watch
That's fixed in place.