Time
An Interactive Fiction by Tristen Allen
Release 1 / Serial number 151109 / Inform 7 build 6L38 (I6/v6.33 lib 6/12N) SD

Jones' Memorial Baptist
There is a crowd gathered here, mourning the loss of your wife.

There is a casket at the front of the room.

>look at casket
In the casket is your wife.

>look at wife
You see nothing special about your wife.

* * *

Time
An Interactive Fiction by Tristen Allen
Release 1 / Serial number 151109 / Inform 7 build 6L38 (I6/v6.33 lib 6/12N) SD

Jones' Memorial Baptist
There is a crowd gathered here, mourning the loss of your wife.

There is a casket at the front of the room.

>look at wife
You see nothing special about your wife.

>take wife
That's fixed in place.

>take casket
Later.

>look at casket
In the casket is your wife.

* * *

Time
An Interactive Fiction by Tristen Allen
Release 1 / Serial number 151109 / Inform 7 build 6L38 (I6/v6.33 lib 6/12N) SD

Jones' Memorial Baptist
There is a crowd gathered here, mourning the loss of your wife.

There is a casket at the front of the room.

>look
Jones' Memorial Baptist
There is a crowd gathered here, mourning the loss of your wife.

There is a casket at the front of the room.

>go north
You can't go that way.

>n
You can't go that way.

>s
You can't go that way.

>ew
That's not a verb I recognise.

>remember
That's not a verb I recognise.

>save
Save failed.

>load
That's not a verb I recognise.

* * *

>look
Jones' Memorial Baptist
There is a crowd gathered here, mourning the loss of your wife.

There is a casket at the front of the room.

>look at casket
Orante, brown, and very expensive.

In the casket is your wife.

>look at wife
Beautiful, you're sure. But you can't quite bring yorself to look at her.

>take wife
It's far too late to hold her.