Interperter
An Interactive Fiction by a bunch of people
Release 1 / Serial number 151117 / Inform 7 build 6L38 (I6/v6.33 lib 6/12N) SD

Jones' Memorial Baptist
There is a crowd gathered here, mourning the loss of your wife.

There is a casket at the front of the room.

You can also see a mysterious figure here.

Outside is the parking lot, with your car and some well-deserved tranquility.
You feel an unfamiliar pressure around your wrist.

>look at crowd
You can't see any such thing.

>look at casket
Orante, brown, and very expensive.

In the casket is a deceased woman.

>look at woman
Beautiful, you're sure. But you can't quite bring yourself to look at her.

>take casket
Later.

>take woman
It's far too late to hold her.

>take car
You can't see any such thing.

>go outside
Outdoors
It's a lovely day outside. Balmy. Partly cloudy. You can hear the birds singing in the distance, as well as the chatter of those standing near the door.

Your Camaro is nearby.

>go camaro
You get into your car.

>drive
That's not a verb I recognise.

>go west
You can't go that way.

>go east
You can't go that way.

>go north
You can't go that way.

>go south
You can't go that way.

>take car
Looks like a good place to get a quick break from today's events.

That seems like it should be the other way around.

>take casket
You can't see any such thing.

>go inside
Before you get going, maybe you should take a quick rest.

>stand
You get out of your car.

Outdoors
It's a lovely day outside. Balmy. Partly cloudy. You can hear the birds singing in the distance, as well as the chatter of those standing near the door.

Your Camaro is nearby.

>go east
You can't go that way.

>go west
You can't go that way.

>take camaro
That seems like it should be the other way around.

>camaro take you
That's not a verb I recognise.

>go inside
Jones' Memorial Baptist
There is a crowd gathered here, mourning the loss of your wife.

There is a casket at the front of the room.

Outside is the parking lot, with your car and some well-deserved tranquility.

>go outside
Outdoors
It's a lovely day outside. Balmy. Partly cloudy. You can hear the birds singing in the distance, as well as the chatter of those standing near the door.

Your Camaro is nearby.

>get in car
You get into your car.

>start car
That's not a verb I recognise.

>start camaro
That's not a verb I recognise.

>talk to people
You can't see any such thing.

>go door
You can't see any such thing.

>look camaro
Looks like a good place to get a quick break from today's events.

>sit camaro
I didn't understand that sentence.

>rest
Your mind begins to drift back to memories of you and your wife.
You begin to drift off to sleep, but are rudely awakened by a question:
"What time is it?"

Bedroom (in your bed)
Your bedroom, with a lovely king-size bed, silk covers, and plenty of space. 
 Light streams in through small cracks in the blinds.

 The kitchen is downstairs from here.

A small watch lies on your bedside table, along with an empty glass.

Your ornate bureau looms rather ominously over your bed.

You can also see a glass (empty) here.

Your wife lies next to you, groggy but awake.

>take watch
Reads 8:31 am. You are late.

Your wife glances at the watch at the same time you do. She seems furious. 
"The kids are going to be late for school! Again! Did you not set the alarm? Actually, scratch that - I don't care. Get ready and meet me downstairs."

She throws on her clothes and storms downstairs.

Taken.

>take glass
Was filled with water before you went to sleep. Now empty and dirty.

It is empty, and needs a wash.

>open bureau
It isn't something you can open.

>look bureau
You should really find a less disturbing-looking centerpiece for your room.

In the bureau is a suit.

>look suit
Your suit is black and sleek, with an off-white kerchief in the pocket of the jacket.

>take suit
Taken.

>take kerchief
You can't see any such thing.

>put on suit
You put on the suit.

>open blinds
You can't see any such thing.

>go downstair
Try going DOWN instead.

>go downstairs
Try going DOWN instead.

>go down
Unless you plan on pushing your bed around, you'll ned to GET OUT of bed first.

>get out of bed
Just GET OUT without saying what you want to exit.

>get out
You get out of your bed.

Bedroom
Your bedroom, with a lovely king-size bed, silk covers, and plenty of space. 
 Light streams in through small cracks in the blinds.

 The kitchen is downstairs from here.

Your ornate bureau looms rather ominously over your bed.

You can also see your bed (empty) and a glass (empty) here.

>take bed
Fluffy. Inviting, safe, comfortable. Take your pick.

That's fixed in place.

>take glass
It is empty, and needs a wash.

>go down
Do you want to be late again? You might need your watch.

>take wath
You can't see any such thing.

>take watch
You already have that.

>go down
Do you want to be late again? You might need your watch.

>put on watch
You put on your watch.

>go down
Kitchen
The kitchen is spacious, but you really don't have the time to prepare a meal.
Outside of the kitchen is the garage, which has both your car and that of your wife's.

Your wife is here, but isn't looking you in the eyes.

There is a box of off-brand cereal here.

>take cereal
You'll have to eat this at work.

Taken.

>talk wife
I didn't understand that sentence.

>ask wife
What do you want to ask your wife for?

>say hi
(to your wife)
There is no reply.

>ask about kids
You can't see any such thing.

>ask about cereal
You can't see any such thing.

>punch wife
Violence isn't the answer to this one.

>go garage
You can't see any such thing.

>go outside
You notice your wife rushing to get the kids ready as you leave the kitchen.
She yells:

"I can't believe you forgot to set the alarm even after I reminded you last night!"

You blow her off, reminding her that you're late to work. You suggest that, perhaps, if she had set her own alarm, this wouldn't be an issue.

She doesn't seem to like that, and coldly ignores you as she goes to the garage.

garage
Your wife's car is gone, leaving only your sleek blue Camaro.

Your Camaro is nearby.

>get in camaro
You get into your car.

>drive
That's not a verb I recognise.

>start
That's not a verb I recognise.

>go
You'll have to say which compass direction to go in.

>north
You can't go that way.

>south
You can't go that way.

>west
You can't go that way.

>east
You can't go that way.

>rest
Your mind begins to drift back to memories of you and your wife.

    *** That was a chaotic morning. Was this really the only memory you had of your wife? Perhaps you should try again. ***

Would you like to RESTART, RESTORE a saved game, QUIT or UNDO the last command?

>undo
garage
[Previous turn undone.]

>restart
Are you sure you want to restart?

>yes
Interperter
An Interactive Fiction by a bunch of people
Release 1 / Serial number 151116 / Inform 7 build 6L38 (I6/v6.33 lib 6/12N) SD

Jones' Memorial Baptist
There is a crowd gathered here, mourning the loss of your wife.

There is a casket at the front of the room.

You can also see a mysterious figure here.

Outside is the parking lot, with your car and some well-deserved tranquility.
You feel an unfamiliar pressure around your wrist.

>look at figure
You can't quite look at him, but he's staring at you.

>ask figure
What do you want to ask the mysterious figure for?

>ask about wife
You can't see any such thing.

>ask About woman
You can't see any such thing.

>ask ABOUT casket
You can't see any such thing.

>look
Jones' Memorial Baptist
There is a crowd gathered here, mourning the loss of your wife.

There is a casket at the front of the room.

You can also see a mysterious figure here.

Outside is the parking lot, with your car and some well-deserved tranquility.
You feel an unfamiliar pressure around your wrist.

>say Hi
(to the mysterious figure)
There is no reply.

>look at wrist
You can't see any such thing.

>look casket
Orante, brown, and very expensive.

In the casket is a deceased woman.

>look woman
Beautiful, you're sure. But you can't quite bring yourself to look at her.

>look crowd
You can't see any such thing.

>go outside
Outdoors
It's a lovely day outside. Balmy. Partly cloudy. You can hear the birds singing in the distance, as well as the chatter of those standing near the door.

Your Camaro is nearby.

>look camaro
Looks like a good place to get a quick break from today's events.

>get in camaro
You get into your car.

>rest
Your mind begins to drift back to memories of you and your wife.

    *** You have reached the end of the demonstration! There really is nothing more here - although there will be! ***

Would you like to RESTART, RESTORE a saved game, QUIT or UNDO the last command?

>restart
Interperter
An Interactive Fiction by a bunch of people
Release 1 / Serial number 151116 / Inform 7 build 6L38 (I6/v6.33 lib 6/12N) SD

Jones' Memorial Baptist
There is a crowd gathered here, mourning the loss of your wife.

There is a casket at the front of the room.

Outside is the parking lot, with your car and some well-deserved tranquility.
You feel an unfamiliar pressure around your wrist.

>go outside
Outdoors
It's a lovely day outside. Balmy. Partly cloudy. You can hear the birds singing in the distance, as well as the chatter of those standing near the door.

Your Camaro is nearby.

* * *

>get in car
You get into your car.

>drive car
That's not a verb I recognise.

>start car
That's not a verb I recognise.

>go inside
Before you get going, maybe you should take a quick rest.

>enter car
But you're already in your car.

>exit car
Just EXIT without saying what you want to exit.

>exit
You get out of your car.

Outdoors
It's a lovely day outside. Balmy. Partly cloudy. You can hear the birds singing in the distance, as well as the chatter of those standing near the door.

Your Camaro is nearby.

>go inside
Jones' Memorial Baptist
There is a crowd gathered here, mourning the loss of your wife.

There is a casket at the front of the room.

Outside is the parking lot, with your car and some well-deserved tranquility.
You feel an unfamiliar pressure around your wrist.

>look at casket
Orante, brown, and very expensive.

In the casket is a deceased woman.

>punch woman
Violence isn't the answer to this one.

>punch casket
Violence isn't the answer to this one.

>talk to figure
You can't see any such thing.

* * *

Interperter
An Interactive Fiction by a bunch of people
Release 1 / Serial number 151117 / Inform 7 build 6L38 (I6/v6.33 lib 6/12N) SD

Jones' Memorial Baptist
There is a crowd gathered here, mourning the loss of your wife.

There is a casket at the front of the room.

You can also see a mysterious figure here.

Outside is the parking lot, with your car and some well-deserved tranquility.
You feel an unfamiliar pressure around your wrist.

>look at wife
You can't see any such thing.

>take wife
You can't see any such thing.

>take casket
Later.

>look at casket
Orante, brown, and very expensive.

In the casket is a deceased woman.

>look at casket
Orante, brown, and very expensive.

In the casket is a deceased woman.

>look at deceased
Beautiful, you're sure. But you can't quite bring yourself to look at her.

* * *

Interperter
An Interactive Fiction by a bunch of people
Release 1 / Serial number 151117 / Inform 7 build 6L38 (I6/v6.33 lib 6/12N) SD

Jones' Memorial Baptist
There is a crowd gathered here, mourning the loss of your wife.

There is a casket at the front of the room.

You can also see a mysterious figure here.

Outside is the parking lot, with your car and some well-deserved tranquility.
You feel an unfamiliar pressure around your wrist.

>inventory
You are carrying:
  a suit (being worn)

>go out
Outdoors
It's a lovely day outside. Balmy. Partly cloudy. You can hear the birds singing in the distance, as well as the chatter of those standing near the door.

Your Camaro is nearby.

>look at suit
Your suit is black and sleek, with an off-white kerchief in the pocket of the jacket.

>get in car
You get into your car.

>sleep
Your mind begins to drift back to memories of you and your wife.
You begin to drift off to sleep, but are rudely awakened by a question:
"What time is it?"

Bedroom (in your bed)
Your bedroom, with a lovely king-size bed, silk covers, and plenty of space. 
 Light streams in through small cracks in the blinds.

 The kitchen is downstairs from here.

A small watch lies on your bedside table, along with an empty glass.

Your ornate bureau looms rather ominously over your bed.

You can also see a glass (empty) here.

Your wife lies next to you, groggy but awake.

>look
Bedroom (in your bed)
Your bedroom, with a lovely king-size bed, silk covers, and plenty of space. 
 Light streams in through small cracks in the blinds.

 The kitchen is downstairs from here.

A small watch lies on your bedside table, along with an empty glass.

Your ornate bureau looms rather ominously over your bed.

You can also see a glass (empty) here.

Your wife lies next to you, groggy but awake.

>look at watch
Reads 8:16 am. You are late.

Your wife glances at the watch at the same time you do. She seems furious. 
"The kids are going to be late for school! Again! Did you not set the alarm? Actually, scratch that - I don't care. Get ready and meet me downstairs."

She throws on her clothes and storms downstairs.

>look in bureau
In the bureau is a suit.

>inventory
You are carrying nothing.

>take watch
Taken.

>take suit
Taken.

>put on suit
You put on the suit.

>put on watch
You put on your watch.

>get out of bed
Just GET OUT without saying what you want to exit.

* * *

>get out
You get out of your bed.

Bedroom
Your bedroom, with a lovely king-size bed, silk covers, and plenty of space. 
 Light streams in through small cracks in the blinds.

 The kitchen is downstairs from here.

Your ornate bureau looms rather ominously over your bed.

You can also see your bed (empty) and a glass (empty) here.

>go down
Kitchen
The kitchen is spacious, but you really don't have the time to prepare a meal.
Outside of the kitchen is the garage, which has both your car and that of your wife's.

Your wife is here, but isn't looking you in the eyes.

There is a box of off-brand cereal here.

>go up
You notice your wife rushing to get the kids ready as you leave the kitchen.
She yells:

"I can't believe you forgot to set the alarm even after I reminded you last night!"

You blow her off, reminding her that you're late to work. You suggest that, perhaps, if she had set her own alarm, this wouldn't be an issue.

She doesn't seem to like that, and coldly ignores you as she goes to the garage.

Bedroom
Your bedroom, with a lovely king-size bed, silk covers, and plenty of space. 
 Light streams in through small cracks in the blinds.

 The kitchen is downstairs from here.

Your ornate bureau looms rather ominously over your bed.

You can also see your bed (empty) and a glass (empty) here.

>go down
Kitchen
The kitchen is spacious, but you really don't have the time to prepare a meal.
Outside of the kitchen is the garage, which has both your car and that of your wife's.

There is a box of off-brand cereal here.

>take off suit
You take off the suit.

>put on suit
You put on the suit.

>go out
garage
Your wife's car is gone, leaving only your sleek blue Camaro.

Your Camaro is nearby.

>get in car
You get into your car.

>sleep
Your mind begins to drift back to memories of you and your wife.

    *** That was a chaotic morning. Was this really the only memory you had of your wife? Perhaps you should try again. ***

Would you like to RESTART, RESTORE a saved game, QUIT or UNDO the last command?

>restart
Interperter
An Interactive Fiction by a bunch of people
Release 1 / Serial number 151116 / Inform 7 build 6L38 (I6/v6.33 lib 6/12N) SD

Jones' Memorial Baptist
There is a crowd gathered here, mourning the loss of your wife.

There is a casket at the front of the room.

You can also see a mysterious figure here.

Outside is the parking lot, with your car and some well-deserved tranquility.
You feel an unfamiliar pressure around your wrist.

>inventory
You are carrying:
  your watch (being worn)
  a suit (being worn)

>look at watch
Reads 8:11 am. You are late.

* * *

Interperter
An Interactive Fiction by a bunch of people
Release 1 / Serial number 151117 / Inform 7 build 6L38 (I6/v6.33 lib 6/12N) SD

Jones' Memorial Baptist
There is a crowd gathered here, mourning the loss of your wife.

There is a casket at the front of the room.

You can also see a mysterious figure here.

Outside is the parking lot, with your car and some well-deserved tranquility.
You feel an unfamiliar pressure around your wrist.

>go out
Outdoors
It's a lovely day outside. Balmy. Partly cloudy. You can hear the birds singing in the distance, as well as the chatter of those standing near the door.

Your Camaro is nearby.

>look at camaro
Looks like a good place to get a quick break from today's events.

>get in car
You get into your car.

* * *

>sleep
Your mind begins to drift back to memories of you and your wife.
You begin to drift off to sleep, but are rudely awakened by a question:
"What time is it?"

Bedroom (in your bed)
Your bedroom, with a lovely king-size bed, silk covers, and plenty of space. 
 Light streams in through small cracks in the blinds.

 The kitchen is downstairs from here.

A small watch lies on your bedside table, along with an empty glass.

Your ornate bureau looms rather ominously over your bed.

You can also see a glass (empty) here.

Your wife lies next to you, groggy but awake.

>take watch
Reads 8:14 am. You are late.

Your wife glances at the watch at the same time you do. She seems furious. 
"The kids are going to be late for school! Again! Did you not set the alarm? Actually, scratch that - I don't care. Get ready and meet me downstairs."

She throws on her clothes and storms downstairs.

Taken.

>get out of bed
Just GET OUT without saying what you want to exit.

* * *

>get out
You get out of your bed.

Bedroom
Your bedroom, with a lovely king-size bed, silk covers, and plenty of space. 
 Light streams in through small cracks in the blinds.

 The kitchen is downstairs from here.

Your ornate bureau looms rather ominously over your bed.

You can also see your bed (empty) and a glass (empty) here.

>look in bureau
In the bureau is a suit.

>look at suit
Your suit is black and sleek, with an off-white kerchief in the pocket of the jacket.

>take suit
Taken.

>go down
You really shouldn't parade about in your birthday suit.

>put on suit
You put on the suit.

>go down
Do you want to be late again? You might need your watch.

>take wtach
You can't see any such thing.

>put on watch
You put on your watch.

>go down
Kitchen
The kitchen is spacious, but you really don't have the time to prepare a meal.

Your wife is here, but isn't looking you in the eyes.

There is a box of off-brand cereal here.

>look at watch
Reads 8:24 am. You are late.

>go up
Bedroom
Your bedroom, with a lovely king-size bed, silk covers, and plenty of space. 
 Light streams in through small cracks in the blinds.

 The kitchen is downstairs from here.

Your ornate bureau looms rather ominously over your bed.

You can also see your bed (empty) and a glass (empty) here.

>look at watch
Reads 8:26 am. You are late.

>look at watch
Reads 8:27 am. You are late.

>go down
Kitchen
The kitchen is spacious, but you really don't have the time to prepare a meal.

Your wife is here, but isn't looking you in the eyes.

There is a box of off-brand cereal here.

>look
Kitchen
The kitchen is spacious, but you really don't have the time to prepare a meal.

Your wife is here, but isn't looking you in the eyes.

There is a box of off-brand cereal here.

>take cereal
You see nothing special about the box of cereal.

Taken.

* * *

>go out
Outdoors
It's a lovely day outside. Balmy. Partly cloudy. You can hear the birds singing in the distance, as well as the chatter of those standing near the door.

Your Camaro is nearby.

>get in car
You get into your car.

>rest
Your mind begins to drift back to memories of you and your wife.

Driveway
Your driveway is immediately outside your garage. You don't really have time to go back inside.

To the north is the highway that you use to get to work everyday.

>wear suit
(first taking the suit)
Your suit is black and sleek, with an off-white kerchief in the pocket of the jacket.

You put on the suit.

>wear watch
(first taking your watch)
Reads 8:14 am. You are late.

Your wife glances at the watch at the same time you do. She seems furious. 
"The kids are going to be late for school! Again! Did you not set the alarm? Actually, scratch that - I don't care. Get ready and meet me downstairs."

She throws on her clothes and storms downstairs.

You put on your watch.

>go down
Unless you plan on pushing your bed around, you'll ned to GET OUT of bed first.

>get out
You get out of your bed.

Bedroom
Your bedroom, with a lovely king-size bed, silk covers, and plenty of space. 
 Light streams in through small cracks in the blinds.

 The kitchen is downstairs from here.

Your ornate bureau looms rather ominously over your bed.

You can also see your bed (empty) and a glass (empty) here.

>eat cereal
You can't see any such thing.

>go down
Kitchen
The kitchen is spacious, but you really don't have the time to prepare a meal.
Outside of the kitchen is the garage, which has both your car and that of your wife.

Your wife is here, but isn't looking you in the eyes.

There is a box of off-brand cereal here.

>eat cereal
(first taking the box of cereal)
This will have to do.

You eat the box of cereal. Not bad.

>go out
You notice your wife rushing to get the kids ready as you prepare to leave the kitchen.
She yells:

"I can't believe you forgot to set the alarm even after I reminded you last night!"

You blow her off, reminding her that you're late to work. You suggest that, perhaps, if she had set her own alarm, this wouldn't be an issue.

She doesn't seem to like that, and coldly ignores you as she goes to the garage.

garage
Your wife's car is gone, leaving only your sleek blue Camaro.

Your Camaro is nearby.

>take car
You really are very tired - a quick nap in your car wouldn't hurt. Just be sure to set the alarm this time.

That seems like it should be the other way around.

>look at car
You really are very tired - a quick nap in your car wouldn't hurt. Just be sure to set the alarm this time.

>get in car
You get into your car.

>rest
Your mind begins to drift back to memories of you and your wife.

    *** That was a chaotic morning. Was this really the only memory you had of your wife? Perhaps you should try again. ***

Would you like to RESTART, RESTORE a saved game, QUIT or UNDO the last command?

>restart
Interperter
An Interactive Fiction by a bunch of people
Release 1 / Serial number 151117 / Inform 7 build 6L38 (I6/v6.33 lib 6/12N) SD

Jones' Memorial Baptist
There is a crowd gathered here, mourning the loss of your wife.

There is a casket at the front of the room.

You can also see a mysterious figure here.

Outside is the parking lot, with your car and some well-deserved tranquility.
You feel an unfamiliar pressure around your wrist.

>take figure
You can't quite look at him, but he's staring at you.

I don't suppose the mysterious figure would care for that.

>ask figure for help
You can't see any such thing.

>ask figure for casket
I don't know who this "mysterious figure" is.

>go out
Outdoors
It's a lovely day outside. Balmy. Partly cloudy. You can hear the birds singing in the distance, as well as the chatter of those standing near the door.

Your Camaro is nearby.

* * *

>rest
Your mind begins to drift back to memories of you and your wife.

Driveway
Your driveway is immediately outside your garage. You don't really have time to go back inside.

To the north is the highway that you use to get to work everyday.

>go north
You should get in your car before going down the highway, friend.

>go in
You should get in your car before going down the highway, friend.

>get in car
You get into your car.

* * *

>look
Driveway (in your car)
Your driveway is immediately outside your garage. You don't really have time to go back inside.

To the north is the highway that you use to get to work everyday.

* * *

>go north
You should get in your car before going down the highway, friend.

>go s
You can't go that way.

>go in
You can't go that way.

>get in car
You get into your car.

* * *

>sleep
Your mind begins to drift back to memories of you and your wife.
You begin to drift off to sleep, but are rudely awakened by a question:
"What time is it?"

Bedroom (in your bed)
Your bedroom, with a lovely king-size bed, silk covers, and plenty of space. 
 Light streams in through small cracks in the blinds.

 The kitchen is downstairs from here.

A small watch lies on your bedside table, along with an empty glass.

Your ornate bureau looms rather ominously over your bed.

You can also see a glass (empty) here.

Your wife lies next to you, groggy but awake.

>take watch
Reads 8:13 am. You are late.

Your wife glances at the watch at the same time you do. She seems furious. 
"The kids are going to be late for school! Again! Did you not set the alarm? Actually, scratch that - I don't care. Get ready and meet me downstairs."

She throws on her clothes and storms downstairs.

Taken.

>look
Bedroom (in your bed)
Your bedroom, with a lovely king-size bed, silk covers, and plenty of space. 
 Light streams in through small cracks in the blinds.

 The kitchen is downstairs from here.

Your ornate bureau looms rather ominously over your bed.

You can also see a glass (empty) here.

>check bureau
You should really find a less disturbing-looking centerpiece for your room.

In the bureau is a suit.

>look at suit
Your suit is black and sleek, with an off-white kerchief in the pocket of the jacket.

>take suit
Your suit is black and sleek, with an off-white kerchief in the pocket of the jacket.

Taken.

* * *

>take watch
Reads 8:13 am. You are late.

Your wife glances at the watch at the same time you do. She seems furious. 
"The kids are going to be late for school! Again! Did you not set the alarm? Actually, scratch that - I don't care. Get ready and meet me downstairs."

She throws on her clothes and storms downstairs.

Taken.

>wear watch
You put on your watch.

>look
Bedroom (in your bed)
Your bedroom, with a lovely king-size bed, silk covers, and plenty of space. 
 Light streams in through small cracks in the blinds.

 The kitchen is downstairs from here.

Your ornate bureau looms rather ominously over your bed.

You can also see a glass (empty) here.

>inventory
You are carrying:
  your watch (being worn)

>look at watch
Reads 8:17 am. You are late.

>take suit
Your suit is black and sleek, with an off-white kerchief in the pocket of the jacket.

Taken.

>look
Bedroom (in your bed)
Your bedroom, with a lovely king-size bed, silk covers, and plenty of space. 
 Light streams in through small cracks in the blinds.

 The kitchen is downstairs from here.

Your ornate bureau looms rather ominously over your bed.

You can also see a glass (empty) here.

>waer suit
That's not a verb I recognise.

>wear suit
You put on the suit.

>look at suit
Your suit is black and sleek, with an off-white kerchief in the pocket of the jacket.

>inventory
You are carrying:
  a suit (being worn)
  your watch (being worn)

>take off suit
You take off the suit.

>remove watch
You take off your watch.

>put on suit and watch
You can't see any such thing.

>put on watch
You put on your watch.

>put on suit
You put on the suit.

>take off suit
You take off the suit.

>go down
Unless you plan on pushing your bed around, you'll ned to GET OUT of bed first.

* * *

>get out
You get out of your bed.

Bedroom
Your bedroom, with a lovely king-size bed, silk covers, and plenty of space. 
 Light streams in through small cracks in the blinds.

 The kitchen is downstairs from here.

Your ornate bureau looms rather ominously over your bed.

You can also see your bed (empty) and a glass (empty) here.

>go down
You really shouldn't parade about in your birthday suit.

>go up
You can't go that way.

* * *

>take watch
Reads 8:13 am. You are late.

Your wife glances at the watch at the same time you do. She seems furious. 
"The kids are going to be late for school! Again! Did you not set the alarm? Actually, scratch that - I don't care. Get ready and meet me downstairs."

She throws on her clothes and storms downstairs.

Taken.

>take suit
Your suit is black and sleek, with an off-white kerchief in the pocket of the jacket.

Taken.

>get out
You get out of your bed.

Bedroom
Your bedroom, with a lovely king-size bed, silk covers, and plenty of space. 
 Light streams in through small cracks in the blinds.

 The kitchen is downstairs from here.

Your ornate bureau looms rather ominously over your bed.

You can also see your bed (empty) and a glass (empty) here.

* * *

>go ut
You can't see any such thing.

>go out
You can't go that way.

>go down
Kitchen
The kitchen is spacious, but you really don't have the time to prepare a meal.
Outside of the kitchen is the garage, which has both your car and that of your wife's.

There is a box of off-brand cereal here.

>go out
garage
Your wife's car is gone, leaving only your sleek blue Camaro.

Your Camaro is nearby.

>go in
Kitchen
The kitchen is spacious, but you really don't have the time to prepare a meal.
Outside of the kitchen is the garage, which has both your car and that of your wife's.

There is a box of off-brand cereal here.

>exit
garage
Your wife's car is gone, leaving only your sleek blue Camaro.

Your Camaro is nearby.

>go in
Kitchen
The kitchen is spacious, but you really don't have the time to prepare a meal.
Outside of the kitchen is the garage, which has both your car and that of your wife's.

There is a box of off-brand cereal here.

* * *

>exit
garage
Your wife's car is gone, leaving only your sleek blue Camaro.

Your Camaro is nearby.

>get in car
You get into your car.

* * *

>rest
Your mind begins to drift back to memories of you and your wife.

    *** That was a chaotic morning. Was this really the only memory you had of your wife? Perhaps you should try again. ***

Would you like to RESTART, RESTORE a saved game, QUIT or UNDO the last command?

>restart
Interperter
An Interactive Fiction by a bunch of people
Release 1 / Serial number 151116 / Inform 7 build 6L38 (I6/v6.33 lib 6/12N) SD

Jones' Memorial Baptist
There is a crowd gathered here, mourning the loss of your wife.

There is a casket at the front of the room.

You can also see a mysterious figure here.

Outside is the parking lot, with your car and some well-deserved tranquility.

>look
Jones' Memorial Baptist
There is a crowd gathered here, mourning the loss of your wife.

There is a casket at the front of the room.

You can also see a mysterious figure here.

Outside is the parking lot, with your car and some well-deserved tranquility.

>look at casket
Orante, brown, and very expensive.

In the casket is a deceased woman.

>inventory
You are carrying:
  your watch (being worn)

>restart
Are you sure you want to restart?

>yes
Interperter
An Interactive Fiction by a bunch of people
Release 1 / Serial number 151116 / Inform 7 build 6L38 (I6/v6.33 lib 6/12N) SD

Jones' Memorial Baptist
There is a crowd gathered here, mourning the loss of your wife.

There is a casket at the front of the room.

You can also see a mysterious figure here.

Outside is the parking lot, with your car and some well-deserved tranquility.

>ask mysterious figure for watch
I don't know who this "mysterious figure" is.

>look
Jones' Memorial Baptist
There is a crowd gathered here, mourning the loss of your wife.

There is a casket at the front of the room.

Outside is the parking lot, with your car and some well-deserved tranquility.

* * *

>get in car
You get into your car.

>look
Outdoors (in your car)
It's a lovely day outside. Balmy. Partly cloudy. You can hear the birds singing in the distance, as well as the chatter of those standing near the door.

>rest
Your mind begins to drift back to memories of you and your wife.
You begin to drift off to sleep, but are rudely awakened by a question:
"What time is it?"

Bedroom (in your bed)
Your bedroom, with a lovely king-size bed, silk covers, and plenty of space. 
 Light streams in through small cracks in the blinds.

 The kitchen is downstairs from here.

A small watch lies on your bedside table, along with an empty glass.

You can also see a glass (empty) here.

Your wife lies next to you, groggy but awake.

>take glass
Was filled with water before you went to sleep. Now empty and dirty.

It is empty, and needs a wash.

>take watch
Reads 8:12. You are late.

Your wife glances at the watch at the same time you do. She seems furious. 
"The kids are going to be late for school! Again! Did you not set the alarm? Actually, scratch that - I don't care. Get ready and meet me downstairs."

Taken.

* * *

>look
Outdoors (in your car)
It's a lovely day outside. Balmy. Partly cloudy. You can hear the birds singing in the distance, as well as the chatter of those standing near the door.

>inventory
You are carrying nothing.

>look at suit
You can't see any such thing.

* * *

>go out
Outdoors
It's a lovely day outside. Balmy. Partly cloudy. You can hear the birds singing in the distance, as well as the chatter of those standing near the door.

Your Camaro is nearby.

>sleep
You really should not be sleeping here.

>get in car
You get into your car.

* * *

>sleep
Your mind begins to drift back to memories of you and your wife.
You begin to drift off to sleep, but are rudely awakened by a question:
"What time is it?"

Bedroom (in your bed)
Your bedroom, with a lovely king-size bed, silk covers, and plenty of space. 
 Light streams in through small cracks in the blinds.

 The kitchen is downstairs from here.

A small watch lies on your bedside table, along with an empty glass.

Your ornate bureau looms rather ominously over your bed.

You can also see a glass (empty) here.

Your wife lies next to you, groggy but awake.

>look at watch
Reads 8:14 am. You are late.

Your wife glances at the watch at the same time you do. She seems furious. 
"The kids are going to be late for school! Again! Did you not set the alarm? Actually, scratch that - I don't care. Get ready and meet me downstairs."

She throws on her clothes and storms downstairs.

>take watch
Taken.

>check bureau
You should really find a less disturbing-looking centerpiece for your room.

In the bureau is a suit.

>equip
That's not a verb I recognise.

>put on watch
You can't wear that!

>wear watch
You can't wear that!

* * *

Interperter
An Interactive Fiction by a bunch of people
Release 1 / Serial number 151117 / Inform 7 build 6L38 (I6/v6.33 lib 6/12N) SD

Jones' Memorial Baptist
There is a crowd gathered here, mourning the loss of your wife.

There is a casket at the front of the room.

You can also see a mysterious figure here.

Outside is the parking lot, with your car and some well-deserved tranquility.
You feel an unfamiliar pressure around your wrist.

>ask mysterious figure
What do you want to ask the mysterious figure for?

>a casket
I don't know who "mysterious figure" is.

>look
Jones' Memorial Baptist
There is a crowd gathered here, mourning the loss of your wife.

There is a casket at the front of the room.

Outside is the parking lot, with your car and some well-deserved tranquility.
There is something different about the casket.

>look
Jones' Memorial Baptist
There is a crowd gathered here, mourning the loss of your wife.

There is a casket at the front of the room.

Outside is the parking lot, with your car and some well-deserved tranquility.
There is something different about the casket.

* * *

Interperter
An Interactive Fiction by a bunch of people
Release 1 / Serial number 151117 / Inform 7 build 6L38 (I6/v6.33 lib 6/12N) SD

Jones' Memorial Baptist
There is a crowd gathered here, mourning the loss of your wife.

There is a casket at the front of the room.

You can also see a mysterious figure here.

Outside is the parking lot, with your car and some well-deserved tranquility.
You feel an unfamiliar pressure around your wrist.

>time
That's not a verb I recognise.

>time of day
That's not a verb I recognise.

>go out
Outdoors
It's a lovely day outside. Balmy. Partly cloudy. You can hear the birds singing in the distance, as well as the chatter of those standing near the door.

Your Camaro is nearby.

* * *

>get in car
You get into your car.

>rest
Your mind begins to drift back to memories of you and your wife.
You begin to drift off to sleep, but are rudely awakened by a question:
"What time is it?"

Bedroom (in your bed)
Your bedroom, with a lovely king-size bed, silk covers, and plenty of space. 
 Light streams in through small cracks in the blinds.

 The kitchen is downstairs from here.

A small watch lies on your bedside table, along with an empty glass.

You can also see a glass (empty) here.

Your wife lies next to you, groggy but awake.

>take watch
Reads 8:13 am. You are late.

Your wife glances at the watch at the same time you do. She seems furious. 
"The kids are going to be late for school! Again! Did you not set the alarm? Actually, scratch that - I don't care. Get ready and meet me downstairs."

She throws on her clothes and storms downstairs.

Taken.

>look at watch
Reads 8:14 am. You are late.

>look at watch
Reads 8:15 am. You are late.

>go downstairs
Try going DOWN instead.

* * *

>go down
Unless you plan on pushing your bed around, you'll ned to GET OUT of bed first.

>get out
You get out of your bed.

Bedroom
Your bedroom, with a lovely king-size bed, silk covers, and plenty of space. 
 Light streams in through small cracks in the blinds.

 The kitchen is downstairs from here.

You can see your bed (empty) and a glass (empty) here.

>go down
Kitchen
The kitchen is spacious, but you really don't have the time to prepare a meal.

Your wife is here, but isn't looking you in the eyes.

>look at wife
Furious. Still lovely, in a very frightening, wrathful way.

>look
Kitchen
The kitchen is spacious, but you really don't have the time to prepare a meal.

Your wife is here, but isn't looking you in the eyes.

>talk to wife
Perhaps you meant to ASK someone about something?

>ask wife about kitchen
She's not in the mood.

* * *

Interperter
An Interactive Fiction by a bunch of people
Release 1 / Serial number 151117 / Inform 7 build 6L38 (I6/v6.33 lib 6/12N) SD

Jones' Memorial Baptist
There is a crowd gathered here, mourning the loss of your wife.

There is a casket at the front of the room.

You can also see a mysterious figure here.

Outside is the parking lot, with your car and some well-deserved tranquility.
You feel an unfamiliar pressure around your wrist.

>look
Jones' Memorial Baptist
There is a crowd gathered here, mourning the loss of your wife.

There is a casket at the front of the room.

Outside is the parking lot, with your car and some well-deserved tranquility.

>look at casket
Orante, brown, and very expensive.

In the casket is a deceased woman.

>look at wife
Beautiful, you're sure. But you can't quite bring yourself to look at her.

>take wife
It's far too late to hold her.

>take casket
Later.

>break casket
Violence isn't the answer to this one.

>attack casket
Violence isn't the answer to this one.

>attack wife
Violence isn't the answer to this one.

* * *

>look at casket
Orante, brown, and very expensive.

In the casket is a deceased woman.

>inventory
You are carrying nothing.

* * *

Interperter
An Interactive Fiction by a bunch of people
Release 1 / Serial number 151117 / Inform 7 build 6L38 (I6/v6.33 lib 6/12N) SD

Jones' Memorial Baptist
There is a crowd gathered here, mourning the loss of your wife.

There is a casket at the front of the room.

You can also see a mysterious figure here.

Outside is the parking lot, with your car and some well-deserved tranquility.
You feel an unfamiliar pressure around your wrist.

>look at watch
You know you didn't have this around your wrist when you walked in. What's going on?

Reads 8:10 am.

>look at watch
Reads 8:11 am.

>ask mysterious figure about watch
I don't know who this "mysterious figure" is.

>look
Jones' Memorial Baptist
There is a crowd gathered here, mourning the loss of your wife.

There is a casket at the front of the room.

Outside is the parking lot, with your car and some well-deserved tranquility.
You feel an unfamiliar pressure around your wrist.

>go out
Outdoors
It's a lovely day outside. Balmy. Partly cloudy. You can hear the birds singing in the distance, as well as the chatter of those standing near the door.

Your Camaro is nearby.

* * *

Interperter
An Interactive Fiction by a bunch of people
Release 1 / Serial number 151117 / Inform 7 build 6L38 (I6/v6.33 lib 6/12N) SD

Jones' Memorial Baptist
There is a crowd gathered here, mourning the loss of your wife.

There is a casket at the front of the room.

You can also see a mysterious figure here.

Outside is the parking lot, with your car and some well-deserved tranquility.
You feel an unfamiliar pressure around your wrist.

>look at casket
Orante, brown, and very expensive.

In the casket is a deceased woman.

>look at crowd
You can't see any such thing.

>go outside
Outdoors
It's a lovely day outside. Balmy. Partly cloudy. You can hear the birds singing in the distance, as well as the chatter of those standing near the door.

Your Camaro is nearby.

>get in camaro
You get into your car.

>close eyes
You can't see any such thing.

>turn on car
It isn't something you can switch.

>breathe
That's not a verb I recognise.

>look around
You can't see any such thing.

>look at car
Looks like a good place to get a quick break from today's events.

>take break
You can't see any such thing.

>start car
That's not a verb I recognise.

>get out of car
Just GET OUT without saying what you want to exit.

>get out
You get out of your car.

Outdoors
It's a lovely day outside. Balmy. Partly cloudy. You can hear the birds singing in the distance, as well as the chatter of those standing near the door.

Your Camaro is nearby.

>get in
You get into your car.

>leave
You get out of your car.

Outdoors
It's a lovely day outside. Balmy. Partly cloudy. You can hear the birds singing in the distance, as well as the chatter of those standing near the door.

Your Camaro is nearby.

>get in
You get into your car.

>look at watch
You can't see any such thing.

>look outside car
I only understood you as far as wanting to look outside.

>look outside
You see nothing unexpected in that direction.

>look around
You can't see any such thing.

>look east
You see nothing unexpected in that direction.

>look west
You see nothing unexpected in that direction.

>look up
You see nothing unexpected in that direction.

>look down
You see nothing unexpected in that direction.

>look south
You see nothing unexpected in that direction.

>look north
You see nothing unexpected in that direction.

>sleep
Your mind begins to drift back to memories of you and your wife.
You begin to drift off to sleep, but are rudely awakened by a question:
"What time is it?"

Bedroom (in your bed)
Your bedroom, with a lovely king-size bed, silk covers, and plenty of space. 
 Light streams in through small cracks in the blinds.

 The kitchen is downstairs from here.

A small watch lies on your bedside table, along with an empty glass.

Your ornate bureau looms rather ominously over your bed.

You can also see a glass (empty) here.

Your wife lies next to you, groggy but awake.

>wear watch
(first taking your watch)
Reads 8:27 am. You are late.

Your wife glances at the watch at the same time you do. She seems furious. 
"The kids are going to be late for school! Again! Did you not set the alarm? Actually, scratch that - I don't care. Get ready and meet me downstairs."

She throws on her clothes and storms downstairs.

You put on your watch.

>get ready
You can't see any such thing.

>get dressed
You can't see any such thing.

>put on clothes
You can't see any such thing.

>go downstairs
Try going DOWN instead.

>down
Unless you plan on pushing your bed around, you'll ned to GET OUT of bed first.

>get out
You get out of your bed.

Bedroom
Your bedroom, with a lovely king-size bed, silk covers, and plenty of space. 
 Light streams in through small cracks in the blinds.

 The kitchen is downstairs from here.

Your ornate bureau looms rather ominously over your bed.

You can also see your bed (empty) and a glass (empty) here.

>look at bureau
You should really find a less disturbing-looking centerpiece for your room.

In the bureau is a suit.

>wear suit
(first taking the suit)
Your suit is black and sleek, with an off-white kerchief in the pocket of the jacket.

You put on the suit.

>go downstairs
Try going DOWN instead.

>down
Kitchen
The kitchen is spacious, but you really don't have the time to prepare a meal.
Outside of the kitchen is the garage, which has both your car and that of your wife's.

Your wife is here, but isn't looking you in the eyes.

There is a box of off-brand cereal here.

>talk to wife
Perhaps you meant to ASK someone about something?

>ask wife
What do you want to ask your wife for?

>leave
You notice your wife rushing to get the kids ready as you leave the kitchen.
She yells:

"I can't believe you forgot to set the alarm even after I reminded you last night!"

You blow her off, reminding her that you're late to work. You suggest that, perhaps, if she had set her own alarm, this wouldn't be an issue.

She doesn't seem to like that, and coldly ignores you as she goes to the garage.

garage
Your wife's car is gone, leaving only your sleek blue Camaro.

Your Camaro is nearby.

>get in
You get into your car.

* * *

>look at casket
Orante, brown, and very expensive.

In the casket is a deceased woman.

>look at wife
You see nothing special about your wife.

* * *

>look at casket
Orante, brown, and very expensive.

In the casket is a deceased woman.

>look
Jones' Memorial Baptist
There is a crowd gathered here, mourning the loss of your wife.

There is a casket at the front of the room.

Outside is the parking lot, with your car and some well-deserved tranquility.

>go outside
Outdoors
It's a lovely day outside. Balmy. Partly cloudy. You can hear the birds singing in the distance, as well as the chatter of those standing near the door.

Your Camaro is nearby.

>look
Outdoors
It's a lovely day outside. Balmy. Partly cloudy. You can hear the birds singing in the distance, as well as the chatter of those standing near the door.

Your Camaro is nearby.

>look at casket
You can't see any such thing.

* * *

Interperter
An Interactive Fiction by a bunch of people
Release 1 / Serial number 151117 / Inform 7 build 6L38 (I6/v6.33 lib 6/12N) SD

Jones' Memorial Baptist
There is a crowd gathered here, mourning the loss of your wife.

There is a casket at the front of the room.

You can also see a mysterious figure here.

Outside is the parking lot, with your car and some well-deserved tranquility.
You feel an unfamiliar pressure around your wrist.

>go outside
Outdoors
It's a lovely day outside. Balmy. Partly cloudy. You can hear the birds singing in the distance, as well as the chatter of those standing near the door.

Your Camaro is nearby.

* * *

>get in car
You get into your car.

>go inside
Before you get going, maybe you should take a quick rest.

>rest
Your mind begins to drift back to memories of you and your wife.
You begin to drift off to sleep, but are rudely awakened by a question:
"What time is it?"

Bedroom (in your bed)
Your bedroom, with a lovely king-size bed, silk covers, and plenty of space. 
 Light streams in through small cracks in the blinds.

 The kitchen is downstairs from here.

A small watch lies on your bedside table, along with an empty glass.

Your ornate bureau looms rather ominously over your bed.

You can also see a glass (empty) here.

Your wife lies next to you, groggy but awake.

>take watch
Reads 8:14 am. You are late.

Your wife glances at the watch at the same time you do. She seems furious. 
"The kids are going to be late for school! Again! Did you not set the alarm? Actually, scratch that - I don't care. Get ready and meet me downstairs."

She throws on her clothes and storms downstairs.

Taken.

>wear suit
(first taking the suit)
Your suit is black and sleek, with an off-white kerchief in the pocket of the jacket.

You put on the suit.

>wear watch
You put on your watch.

>get out
You get out of your bed.

Bedroom
Your bedroom, with a lovely king-size bed, silk covers, and plenty of space. 
 Light streams in through small cracks in the blinds.

 The kitchen is downstairs from here.

Your ornate bureau looms rather ominously over your bed.

You can also see your bed (empty) and a glass (empty) here.

>go down
Kitchen
The kitchen is spacious, but you really don't have the time to prepare a meal.
Outside of the kitchen is the garage, which has both your car and that of your wife.

Your wife is here, but isn't looking you in the eyes.

There is a box of off-brand cereal here.

>take cereal
You'll have to eat this at work.

Taken.

>eat cereal
You eat the box of cereal. Not bad.

>look
Kitchen
The kitchen is spacious, but you really don't have the time to prepare a meal.
Outside of the kitchen is the garage, which has both your car and that of your wife.

Your wife is here, but isn't looking you in the eyes.

>incentory
That's not a verb I recognise.

>inventory
You are carrying:
  a suit (being worn)
  your watch (being worn)

>go down
You notice your wife rushing to get the kids ready as you prepare to leave the kitchen.
She yells:

"I can't believe you forgot to set the alarm even after I reminded you last night!"

You blow her off, reminding her that you're late to work. You suggest that, perhaps, if she had set her own alarm, this wouldn't be an issue.

She doesn't seem to like that, and coldly ignores you as she goes to the garage.

You can't go that way.

>go out
garage
Your wife's car is gone, leaving only your sleek blue Camaro.

Your Camaro is nearby.

* * *

>get in car
You get into your car.

>go in
Before you get going, maybe you should take a quick rest.

>rest
Your mind begins to drift back to memories of you and your wife.

    *** That was a chaotic morning. Was this really the only memory you had of your wife? Perhaps you should try again. ***

Would you like to RESTART, RESTORE a saved game, QUIT or UNDO the last command?

* * *

>restart
Interperter
An Interactive Fiction by a bunch of people
Release 1 / Serial number 151117 / Inform 7 build 6L38 (I6/v6.33 lib 6/12N) SD

Jones' Memorial Baptist
There is a crowd gathered here, mourning the loss of your wife.

There is a casket at the front of the room.

You can also see a mysterious figure here.

Outside is the parking lot, with your car and some well-deserved tranquility.
You feel an unfamiliar pressure around your wrist.

>inventory
You are carrying:
  your watch (being worn)
  a suit (being worn)

>look at wrist
You can't see any such thing.

>look at self
As good-looking as ever.

>take watch
You know you didn't have this around your wrist when you walked in. What's going on?

Reads 8:12 am.

You already have that.

>look at watch
Reads 8:13 am.

>go out
Outdoors
It's a lovely day outside. Balmy. Partly cloudy. You can hear the birds singing in the distance, as well as the chatter of those standing near the door.

Your Camaro is nearby.

* * *

>get in car
You get into your car.

>sleep
Your mind begins to drift back to memories of you and your wife.

Driveway
Your driveway is immediately outside your garage. You don't really have time to go back inside.

To the north is the highway that you use to get to work everyday.

>look
Driveway
Your driveway is immediately outside your garage. You don't really have time to go back inside.

To the north is the highway that you use to get to work everyday.

Your Camaro is nearby.

>get in car
You get into your car.

>rest
What do you think you're doing!?

>look
Driveway (in your car)
Your driveway is immediately outside your garage. You don't really have time to go back inside.

To the north is the highway that you use to get to work everyday.

>go north
You can't go that way.

* * *

>go outside
Outdoors
It's a lovely day outside. Balmy. Partly cloudy. You can hear the birds singing in the distance, as well as the chatter of those standing near the door.

Your Camaro is nearby.

>go inside
Jones' Memorial Baptist
There is a crowd gathered here, mourning the loss of your wife.

There is a casket at the front of the room.

Outside is the parking lot, with your car and some well-deserved tranquility.

>look at mysterious ifgure
You can't see any such thing.

>look at figure
You can't see any such thing.

>ask figure for watch
You can't see any such thing.

>inventory
You are carrying:
  a suit (being worn)

>get in car
You can't see any such thing.

>go out
Outdoors
It's a lovely day outside. Balmy. Partly cloudy. You can hear the birds singing in the distance, as well as the chatter of those standing near the door.

Your Camaro is nearby.

* * *

>go in
Before you get going, maybe you should take a quick rest.

>rest
Your mind begins to drift back to memories of you and your wife.
You begin to drift off to sleep, but are rudely awakened by a question:
"What time is it?"

Bedroom (in your bed)
Your bedroom, with a lovely king-size bed, silk covers, and plenty of space. 
 Light streams in through small cracks in the blinds.

 The kitchen is downstairs from here.

A small watch lies on your bedside table, along with an empty glass.

Your ornate bureau looms rather ominously over your bed.

You can also see a glass (empty) here.

Your wife lies next to you, groggy but awake.

>take watch
Reads 8:17 am. You are late.

Your wife glances at the watch at the same time you do. She seems furious. 
"The kids are going to be late for school! Again! Did you not set the alarm? Actually, scratch that - I don't care. Get ready and meet me downstairs."

She throws on her clothes and storms downstairs.

Taken.

>get out
You get out of your bed.

Bedroom
Your bedroom, with a lovely king-size bed, silk covers, and plenty of space. 
 Light streams in through small cracks in the blinds.

 The kitchen is downstairs from here.

Your ornate bureau looms rather ominously over your bed.

You can also see your bed (empty) and a glass (empty) here.

>take suit
Your suit is black and sleek, with an off-white kerchief in the pocket of the jacket.

Taken.

>go down
You really shouldn't parade about in your birthday suit.

>wear suit
You put on the suit.

>go down
Do you want to be late again? You might need your watch.

>wear watch
You put on your watch.

>go down
Kitchen
The kitchen is spacious, but you really don't have the time to prepare a meal.
Outside of the kitchen is the garage, which has both your car and that of your wife.

Your wife is here, but isn't looking you in the eyes.

There is a box of off-brand cereal here.

>eat cereal
(first taking the box of cereal)
You'll have to eat this at work.

You eat the box of cereal. Not bad.