Interperter
An Interactive Fiction by a bunch of people
Release 1 / Serial number 151111 / Inform 7 build 6L38 (I6/v6.33 lib 6/12N) SD

Jones' Memorial Baptist
There is a crowd gathered here, mourning the loss of your wife.

There is a casket at the front of the room.

You can also see a mysterious figure here.

Outside is the parking lot, with your car and some well-deserved tranquility.
There is something different about the casket.

>look
Jones' Memorial Baptist
There is a crowd gathered here, mourning the loss of your wife.

There is a casket at the front of the room.

Outside is the parking lot, with your car and some well-deserved tranquility.

>look at casket
Orante, brown, and very expensive.

In the casket is your wife.

>look at wife
Beautiful, you're sure. But you can't quite bring yourself to look at her.

* * *

>get in car
You get into your car.

>rest
Your mind begins to drift back to memories of you and your wife.

>go inside
You have nowhere to go. You could walk back inside, or maybe REST a while.

>exit
You get out of your car.

Outdoors
It's a lovely day outside. Balmy. Partly cloudy. You can hear the birds singing in the distance, as well as the chatter of those standing near the door.

Your Camaro is nearby.

>go inside
Jones' Memorial Baptist
There is a crowd gathered here, mourning the loss of your wife.

There is a casket at the front of the room.

Outside is the parking lot, with your car and some well-deserved tranquility.

This seems oddly familiar.

There is a small boquet of flowers on top of the casket.

>look at casket
Orante, brown, and very expensive.

In the casket are a boquet and your wife.

>take boquet
Taken.

>look at boquet
From your first date.

>exit
Outdoors
It's a lovely day outside. Balmy. Partly cloudy. You can hear the birds singing in the distance, as well as the chatter of those standing near the door.

Your Camaro is nearby.

>quit
Are you sure you want to quit?

* * *

Interperter
An Interactive Fiction by a bunch of people
Release 1 / Serial number 151111 / Inform 7 build 6L38 (I6/v6.33 lib 6/12N) SD

Jones' Memorial Baptist
There is a crowd gathered here, mourning the loss of your wife.

There is a casket at the front of the room.

You can also see a mysterious figure here.

Outside is the parking lot, with your car and some well-deserved tranquility.
There is something different about the casket.

>rest
You really should not be sleeping here.

>go outside
Outdoors
It's a lovely day outside. Balmy. Partly cloudy. You can hear the birds singing in the distance, as well as the chatter of those standing near the door.

Your Camaro is nearby.

* * *

>get in car
You get into your car.

>rest
Your mind begins to drift back to memories of you and your wife.

This seems oddly familiar.

There is a small boquet of flowers on top of the casket.

* * *

Interperter
An Interactive Fiction by a bunch of people
Release 1 / Serial number 151111 / Inform 7 build 6L38 (I6/v6.33 lib 6/12N) SD

Jones' Memorial Baptist
There is a crowd gathered here, mourning the loss of your wife.

There is a casket at the front of the room.

You can also see a mysterious figure here.

Outside is the parking lot, with your car and some well-deserved tranquility.
There is something different about the casket.

>ask mysterious figure
What do you want to ask the mysterious figure for?

* * *

Interperter
An Interactive Fiction by a bunch of people
Release 1 / Serial number 151111 / Inform 7 build 6L38 (I6/v6.33 lib 6/12N) SD

Jones' Memorial Baptist
There is a crowd gathered here, mourning the loss of your wife.

There is a casket at the front of the room.

You can also see a mysterious figure here.

Outside is the parking lot, with your car and some well-deserved tranquility.
There is something different about the casket.

>talk to mysterious figure
That noun did not make sense in this context.

>talk
Perhaps you meant to ASK someone about something?

* * *

>talk to mysterious figure
That noun did not make sense in this context.

>talk to figure
That noun did not make sense in this context.

* * *

Interperter
An Interactive Fiction by a bunch of people
Release 1 / Serial number 151111 / Inform 7 build 6L38 (I6/v6.33 lib 6/12N) SD

Jones' Memorial Baptist
There is a crowd gathered here, mourning the loss of your wife.

There is a casket at the front of the room.

You can also see a mysterious figure here.

Outside is the parking lot, with your car and some well-deserved tranquility.
There is something different about the casket.

>look at casket
Orante, brown, and very expensive.

In the casket are a boquet and your wife.

>look at wife
You see nothing special about your wife.

* * *

>look at casket
Orante, brown, and very expensive.

In the casket are a boquet and your wife.

>look
Jones' Memorial Baptist
There is a crowd gathered here, mourning the loss of your wife.

There is a casket at the front of the room.

Outside is the parking lot, with your car and some well-deserved tranquility.

* * *

Interperter
An Interactive Fiction by a bunch of people
Release 1 / Serial number 151111 / Inform 7 build 6L38 (I6/v6.33 lib 6/12N) SD

Jones' Memorial Baptist
There is a crowd gathered here, mourning the loss of your wife.

There is a casket at the front of the room.

You can also see a mysterious figure here.

Outside is the parking lot, with your car and some well-deserved tranquility.
There is something different about the casket.

>ask
What do you want to ask the mysterious figure for?

>help
You can't see any such thing.

>casket
That's not a verb I recognise.

>look
Jones' Memorial Baptist
There is a crowd gathered here, mourning the loss of your wife.

There is a casket at the front of the room.

You can also see a mysterious figure here.

Outside is the parking lot, with your car and some well-deserved tranquility.
There is something different about the casket.

>look at figure
You can't quite look at him, but he's staring at you.

>talk to figure
Perhaps you meant to ASK someone about something?

>ask figure for casket
I don't know who this "mysterious figure" is.

>look
Jones' Memorial Baptist
There is a crowd gathered here, mourning the loss of your wife.

There is a casket at the front of the room.

Outside is the parking lot, with your car and some well-deserved tranquility.
There is something different about the casket.

>xyzzy\
That's not a verb I recognise.

>xyzzy
Incredible! If you were magic, maybe that would have done something.

* * *

Interperter
An Interactive Fiction by a bunch of people
Release 1 / Serial number 151111 / Inform 7 build 6L38 (I6/v6.33 lib 6/12N) SD

Jones' Memorial Baptist
There is a crowd gathered here, mourning the loss of your wife.

There is a casket at the front of the room.

You can also see a mysterious figure here.

Outside is the parking lot, with your car and some well-deserved tranquility.
There is something different about the casket.

>look at wife
Beautiful, you're sure. But you can't quite bring yourself to look at her.

* * *

>take casket
Later.

>look at casket
Orante, brown, and very expensive.

In the casket is your wife.

* * *

Interperter
An Interactive Fiction by a bunch of people
Release 1 / Serial number 151111 / Inform 7 build 6L38 (I6/v6.33 lib 6/12N) SD

Jones' Memorial Baptist
There is a crowd gathered here, mourning the loss of your wife.

There is a casket at the front of the room.

You can also see a mysterious figure here.

Outside is the parking lot, with your car and some well-deserved tranquility.
There is something different about the casket.

>take boquet
You can't see any such thing.

>look
Jones' Memorial Baptist
There is a crowd gathered here, mourning the loss of your wife.

There is a casket at the front of the room.

Outside is the parking lot, with your car and some well-deserved tranquility.

* * *

>go outside
Outdoors
It's a lovely day outside. Balmy. Partly cloudy. You can hear the birds singing in the distance, as well as the chatter of those standing near the door.

Your Camaro is nearby.

>take car
That seems like it should be the other way around.

>go to car
You can't see any such thing.

>get in car
You get into your car.

* * *

>look
Outdoors (in your car)
It's a lovely day outside. Balmy. Partly cloudy. You can hear the birds singing in the distance, as well as the chatter of those standing near the door.

>drive
That's not a verb I recognise.

>go inside
Jones' Memorial Baptist (in your car)
There is a crowd gathered here, mourning the loss of your wife.

There is a casket at the front of the room.

Outside is the parking lot, with your car and some well-deserved tranquility.

>go outside
Outdoors (in your car)
It's a lovely day outside. Balmy. Partly cloudy. You can hear the birds singing in the distance, as well as the chatter of those standing near the door.

* * *

Interperter
An Interactive Fiction by a bunch of people
Release 1 / Serial number 151111 / Inform 7 build 6L38 (I6/v6.33 lib 6/12N) SD

Jones' Memorial Baptist
There is a crowd gathered here, mourning the loss of your wife.

There is a casket at the front of the room.

You can also see a mysterious figure here.

Outside is the parking lot, with your car and some well-deserved tranquility.
There is something different about the casket.

>loo
That's not a verb I recognise.

>look
Jones' Memorial Baptist
There is a crowd gathered here, mourning the loss of your wife.

There is a casket at the front of the room.

Outside is the parking lot, with your car and some well-deserved tranquility.

This seems oddly familiar.

There is a small boquet of flowers on top of the casket.

* * *

Interperter
An Interactive Fiction by a bunch of people
Release 1 / Serial number 151111 / Inform 7 build 6L38 (I6/v6.33 lib 6/12N) SD

Jones' Memorial Baptist
There is a crowd gathered here, mourning the loss of your wife.

There is a casket at the front of the room.

You can also see a mysterious figure here.

Outside is the parking lot, with your car and some well-deserved tranquility.
There is something different about the casket.

>xyzzy
Incredible! If you were magic, maybe that would have done something.

* * *

Interperter
An Interactive Fiction by a bunch of people
Release 1 / Serial number 151111 / Inform 7 build 6L38 (I6/v6.33 lib 6/12N) SD

Jones' Memorial Baptist
There is a crowd gathered here, mourning the loss of your wife.

There is a casket at the front of the room.

You can also see a mysterious figure here.

Outside is the parking lot, with your car and some well-deserved tranquility.
There is something different about the casket.

>talk
(to the mysterious figure)
Perhaps you meant to ASK someone about something?

>help
You can't see any such thing.

>talk to mysterious figure about the clouds
You can't see any such thing.

>talk to mysterious figure about me
You can't see any such thing.

>talk to mysterious figure about him
You can't see any such thing.

>look
Jones' Memorial Baptist
There is a crowd gathered here, mourning the loss of your wife.

There is a casket at the front of the room.

You can also see a mysterious figure here.

Outside is the parking lot, with your car and some well-deserved tranquility.
There is something different about the casket.

>talk to mysterious figure about himself
You can't see any such thing.

>talk
What do you want to talk the mysterious figure for?

>himself
You can't see any such thing.

>talk
What do you want to talk the mysterious figure for?

>me
(the mysterious figure first taking yourself)
The mysterious figure has better things to do.

>look at mysterious figure
You can't quite look at him, but he's staring at you.

>look
Jones' Memorial Baptist
There is a crowd gathered here, mourning the loss of your wife.

There is a casket at the front of the room.

You can also see a mysterious figure here.

Outside is the parking lot, with your car and some well-deserved tranquility.
There is something different about the casket.

>take mysterious figure
I don't suppose the mysterious figure would care for that.

* * *

>talk
(to the mysterious figure)
Perhaps you meant to ASK someone about something?

>the mysterious figure
Perhaps you meant to ASK someone about something?

* * *

>talk
(to the mysterious figure)
Perhaps you meant to ASK someone about something?

>ask figure
What do you want to ask the mysterious figure for?

>help
You can't see any such thing.

>ask figure for himself
You can't see any such thing.

>ask figure about himself
I don't know who "mysterious figure" is.

He isn't available.

* * *

>ask figure
What do you want to ask the mysterious figure for?

>casket
I don't know who this "mysterious figure" is.

He isn't available.

>look
Jones' Memorial Baptist
There is a crowd gathered here, mourning the loss of your wife.

There is a casket at the front of the room.

Outside is the parking lot, with your car and some well-deserved tranquility.
There is something different about the casket.

* * *

>talk
(to the mysterious figure)
Perhaps you meant to ASK someone about something?

>figure
Perhaps you meant to ASK someone about something?

* * *

Interperter
An Interactive Fiction by a bunch of people
Release 1 / Serial number 151111 / Inform 7 build 6L38 (I6/v6.33 lib 6/12N) SD

Jones' Memorial Baptist
There is a crowd gathered here, mourning the loss of your wife.

There is a casket at the front of the room.

You can also see a mysterious figure here.

Outside is the parking lot, with your car and some well-deserved tranquility.
There is something different about the casket.

>look at figure
You can't quite look at him, but he's staring at you.

>ask figure for help
You can't see any such thing.

>ask figure
What do you want to ask the mysterious figure for?

>a friend
You can't see any such thing.

>help
That's not a verb I recognise.

>ask figure about me
There is no reply.

* * *

Interperter
An Interactive Fiction by a bunch of people
Release 1 / Serial number 151111 / Inform 7 build 6L38 (I6/v6.33 lib 6/12N) SD

Jones' Memorial Baptist
There is a crowd gathered here, mourning the loss of your wife.

There is a casket at the front of the room.

You can also see a mysterious figure here.

Outside is the parking lot, with your car and some well-deserved tranquility.
There is something different about the casket.

>look at mysterious figure
You can't quite look at him, but he's staring at you.

>ask mysterious figure about himself
There is no reply.

>ask mysterious figure about anything
There is no reply.

>ask mysterious figure
What do you want to ask the mysterious figure for?

>no
That was a rhetorical question.

>no
That was a rhetorical question.

>yes
That was a rhetorical question.

>please
That's not a verb I recognise.

>help
That's not a verb I recognise.

>ask mysterious figure
What do you want to ask the mysterious figure for?

* * *

Interperter
An Interactive Fiction by a bunch of people
Release 1 / Serial number 151111 / Inform 7 build 6L38 (I6/v6.33 lib 6/12N) SD

Jones' Memorial Baptist
There is a crowd gathered here, mourning the loss of your wife.

There is a casket at the front of the room.

You can also see a mysterious figure here.

Outside is the parking lot, with your car and some well-deserved tranquility.
There is something different about the casket.

>ask mysterious figure about himself
I don't know who "mysterious figure" is.

He isn't available.

>ask
What do you want to ask the mysterious figure for?