In Memoriam
An Interactive Fiction by Loquacious Libriform Computing
Release 1 / Serial number 151120 / Inform 7 build 6L38 (I6/v6.33 lib 6/12N) SD

Jones' Memorial Baptist
There is a crowd gathered here, mourning the loss of a loved one.

There is a casket at the front of the room.

You can also see a mysterious figure here.

Outside is the parking lot, with your car and some well-deserved tranquility.
You feel an unfamiliar pressure around your wrist.

>look at wife
You can't see any such thing.

* * *

In Memoriam
An Interactive Fiction by Loquacious Libriform Computing
Release 1 / Serial number 151120 / Inform 7 build 6L38 (I6/v6.33 lib 6/12N) SD

Jones' Memorial Baptist
There is a crowd gathered here, mourning the loss of a loved one.

There is a casket at the front of the room.

You can also see a mysterious figure here.

Outside is the parking lot, with your car and some well-deserved tranquility.
You feel an unfamiliar pressure around your wrist.

>ask mysterious figure
What do you want to ask the mysterious figure for?

* * *

In Memoriam
An Interactive Fiction by Loquacious Libriform Computing
Release 1 / Serial number 151120 / Inform 7 build 6L38 (I6/v6.33 lib 6/12N) SD

Jones' Memorial Baptist
There is a crowd gathered here, mourning the loss of a loved one.

There is a casket at the front of the room.

You can also see a mysterious figure here.

Outside is the parking lot, with your car and some well-deserved tranquility.
You feel an unfamiliar pressure around your wrist.

>look
Jones' Memorial Baptist
There is a crowd gathered here, mourning the loss of your wife.

There is a casket at the front of the room.

Outside is the parking lot, with your car and some well-deserved tranquility.

* * *

In Memoriam
An Interactive Fiction by Loquacious Libriform Computing
Release 1 / Serial number 151120 / Inform 7 build 6L38 (I6/v6.33 lib 6/12N) SD

Jones' Memorial Baptist
There is a crowd gathered here, mourning the loss of a loved one.

There is a casket at the front of the room.

You can also see a mysterious figure here.

Outside is the parking lot, with your car and some well-deserved tranquility.
You feel an unfamiliar pressure around your wrist.

>look at casket
Orante, brown, and very expensive.

In the casket is a deceased woman.

* * *

In Memoriam
An Interactive Fiction by Loquacious Libriform Computing
Release 1 / Serial number 151120 / Inform 7 build 6L38 (I6/v6.33 lib 6/12N) SD

Jones' Memorial Baptist
There is a crowd gathered here, mourning the loss of a loved one.

There is a casket at the front of the room.

You can also see a mysterious figure here.

Outside is the parking lot, with your car and some well-deserved tranquility.
You feel an unfamiliar pressure around your wrist.

>ask mysterious figure about your wife
I don't know who this "mysterious figure" is.

>go out
Outdoors
It's a lovely day outside. Balmy. Partly cloudy. You can hear the birds singing in the distance, as well as the chatter of those standing near the door.

Your Camaro is nearby.

* * *

>rest
Your mind begins to drift back to memories of you and your wife.

Driveway
Your driveway is immediately outside your garage. You don't really have time to go back inside.

To the north is the highway that you use to get to work everyday.

>sleep
You really should not be sleeping here.

>look
Driveway
Your driveway is immediately outside your garage. You don't really have time to go back inside.

To the north is the highway that you use to get to work everyday.

Your Camaro is nearby.

* * *

>get in car
You get into your car.

>go n
Highway (in your car)
Full of cars. Calming, for once. North of here is your workplace; south is your driveway.

>sleep
What do you think you're doing!?

>rest
What do you think you're doing!?

>go s
Driveway (in your car)
Your driveway is immediately outside your garage. You don't really have time to go back inside.

To the north is the highway that you use to get to work everyday.

>go n
Highway (in your car)
Full of cars. Calming, for once. North of here is your workplace; south is your driveway.

>go n
Your boss runs up to you as you pull into your parking space, a look of blank shock on his face.
You stare at him, confused, and open the door to step out and get your mind off of the argument you had this morning.

"Son, why in God's name are you here? Check your phone!"

You pre-emptively apologize, remembering that you left your phone in your cubicle, and inform your boss as such.

"Then I'm sorry to have to be the one to tell you this."
He pauses, uneasy at the message he is now being forced to deliver.

"Your wife's dead, son."
Your boss walks inside after giving you the weekend off. He glances sadly at you before walking back inside.
You begin to breathe rapidly. Thoughts flash through your mind. Why did you have to argue with your wife? Why does this seem so familiar? Why is he here?

>look
Workplace (in your car)
Here, you serve as a consultant for many top businesses in the area. You make enough to allow your wife to stay at home, but she has always mentioned wanting to go back to college for another degree.

* * *

In Memoriam
An Interactive Fiction by Loquacious Libriform Computing
Release 1 / Serial number 151120 / Inform 7 build 6L38 (I6/v6.33 lib 6/12N) SD

Jones' Memorial Baptist
There is a crowd gathered here, mourning the loss of a loved one.

There is a casket at the front of the room.

You can also see a mysterious figure here.

Outside is the parking lot, with your car and some well-deserved tranquility.
You feel an unfamiliar pressure around your wrist.

>go out
Outdoors
It's a lovely day outside. Balmy. Partly cloudy. You can hear the birds singing in the distance, as well as the chatter of those standing near the door.

Your Camaro is nearby.

>get in car
Looks like a good place to get a quick break from today's events. You might try taking a quick REST here.

(You are now in the car).

>rest
Your mind begins to drift back to memories of you and your wife.

Driveway
Your driveway is immediately outside your garage. You don't really have time to go back inside.

To the north is the highway that you use to get to work everyday.

Your Camaro is nearby.

>get in care
You can't see any such thing.

>get in car
You get into your car.

>inventory
You are carrying:
  your watch (being worn)
  a suit (being worn)

>n
Highway (in your car)
Full of cars. Calming, for once. North of here is your workplace; south is your driveway.

>n
Workplace (in your car)
Here, you serve as a consultant for many top businesses in the area. You make enough to allow your wife to stay at home, but she has always mentioned wanting to go back to college for another degree.

You can see a mysterious figure here.

Your boss runs up to you as you pull into your parking space, a look of blank shock on his face.
You stare at him, confused, and open the door to step out and get your mind off of the argument you had this morning.

"Son, why in God's name are you here? Check your phone!"

You pre-emptively apologize, remembering that you left your phone in your cubicle, and inform your boss as such.

"Then I'm sorry to have to be the one to tell you this."
He pauses, uneasy at the message he is now being forced to deliver.

"Your wife's dead, son."
Your boss walks inside after giving you the weekend off. He glances sadly at you before walking back inside.
You begin to breathe rapidly. Thoughts flash through your mind. Why did you have to argue with your wife? Why does this seem so familiar? Why is he here?

>look
Workplace (in your car)
Here, you serve as a consultant for many top businesses in the area. You make enough to allow your wife to stay at home, but she has always mentioned wanting to go back to college for another degree.

You can see a mysterious figure here.

>talk to figure
Perhaps you meant to ASK someone about something?

>ask figure about phone
There is no reply.

>ask figure about time
There is no reply.

>ask figure about me
There is no reply.

>ask figure about you
There is no reply.

>ask figure for help
You can't see any such thing.

>ask figure about things
You could ask him about YOUR WIFE, THE STORY, HIMSELF, or HELP.

>ask figure about time
There is no reply.

>ask figure about time
There is no reply.

>ask figure about wife
There is no reply.

>ask figure about your wife
I'm not responsible for how she dies, if that's what you're wondering.

>ask figure about the story
Very astute. Yes, you're in one. And it's not about you, no. But it is about YOU.
See you later. Or earlier. Take your pick; doesn't matter to me.
Here's your phone. Hold on to it. You might want it.
(You are now carrying the phone.)

>inventory
You are carrying:
  a phone
  your watch (being worn)
  a suit (being worn)

>look at phone
No unread messages. Has your wife's phone number on it.

>restart
Are you sure you want to restart?

>yes
Interperter
An Interactive Fiction by Loquacious Libriform Computing
Release 1 / Serial number 151119 / Inform 7 build 6L38 (I6/v6.33 lib 6/12N) SD

Jones' Memorial Baptist
There is a crowd gathered here, mourning the loss of a loved one.

There is a casket at the front of the room.

You can also see a mysterious figure here.

Outside is the parking lot, with your car and some well-deserved tranquility.
You feel an unfamiliar pressure around your wrist.

* * *

>get in car
Looks like a good place to get a quick break from today's events. You might try taking a quick REST here.

(You are now in the car).

>look
Outdoors (in your car)
It's a lovely day outside. Balmy. Partly cloudy. You can hear the birds singing in the distance, as well as the chatter of those standing near the door.

>rest
Your mind begins to drift back to memories of you and your wife.
You begin to drift off to sleep, but are rudely awakened by a question:
"What time is it?"

Bedroom (in your bed)
Your bedroom, with a lovely king-size bed, silk covers, and plenty of space. 
 Light streams in through small cracks in the blinds.

 The kitchen is downstairs from here.

A small watch lies on your bedside table, along with an empty glass.

Your ornate bureau looms rather ominously over your bed.

You can also see a glass (empty) here.

Your wife lies next to you, groggy but awake.

* * *

>take watch
Reads 8:14 am. You are late.

Your wife glances at the watch at the same time you do. She seems furious. 
"The kids are going to be late for school! Again! Did you not set the alarm? Actually, scratch that - I don't care. Get ready and meet me downstairs."

She throws on her clothes and storms downstairs.

Taken.

>go down
Unless you plan on pushing your bed around, you'll ned to GET OUT of bed first.

* * *

>get out
You get out of your bed.

Bedroom
Your bedroom, with a lovely king-size bed, silk covers, and plenty of space. 
 Light streams in through small cracks in the blinds.

 The kitchen is downstairs from here.

Your ornate bureau looms rather ominously over your bed.

You can also see your bed (empty) and a glass (empty) here.

>wear watch
You put on your watch.

>wear suit
(first taking the suit)
Your suit is black and sleek, with an off-white kerchief in the pocket of the jacket.

You put on the suit.

>d
Kitchen
The kitchen is spacious, but you really don't have the time to prepare a meal.
Outside of the kitchen is the garage, which has both your car and that of your wife.

Your wife is here, but isn't looking you in the eyes.

There is a box of off-brand cereal here.

>eat cereal
(first taking the box of cereal)
This will have to do.

You eat the box of cereal. Not bad.

* * *

>go out
You notice your wife rushing to get the kids ready as you prepare to leave the kitchen.
She yells:

"I can't believe you forgot to set the alarm even after I reminded you last night!"

You blow her off, reminding her that you're late to work. You suggest that, perhaps, if she had set her own alarm, this wouldn't be an issue.

She doesn't seem to like that, and coldly ignores you as she goes to the garage.

garage
Your wife's car is gone, leaving only your sleek blue Camaro.

Your Camaro is nearby.

>get in car
You really are very tired - a quick nap in your car wouldn't hurt. Just be sure to set the alarm this time.

(You are now in the car).

>rest
Your mind begins to drift back to memories of you and your wife.

    *** That was a chaotic morning. Was this really the only memory you had of your wife? Perhaps you should try again. ***

Would you like to RESTART, RESTORE a saved game, QUIT or UNDO the last command?

>restart
Interperter
An Interactive Fiction by Loquacious Libriform Computing
Release 1 / Serial number 151120 / Inform 7 build 6L38 (I6/v6.33 lib 6/12N) SD

Jones' Memorial Baptist
There is a crowd gathered here, mourning the loss of a loved one.

There is a casket at the front of the room.

You can also see a mysterious figure here.

Outside is the parking lot, with your car and some well-deserved tranquility.
You feel an unfamiliar pressure around your wrist.

>check wrist
You can't see any such thing.

>check self
As good-looking as ever.

>inventory
You are carrying:
  your watch (being worn)
  a suit (being worn)

>talk to figure about wife
I only understood you as far as wanting to talk to the mysterious figure.

>ask figure about deceased
I don't know who this "mysterious figure" is.

>go out
Outdoors
It's a lovely day outside. Balmy. Partly cloudy. You can hear the birds singing in the distance, as well as the chatter of those standing near the door.

Your Camaro is nearby.

* * *

>get in car
Looks like a good place to get a quick break from today's events. You might try taking a quick REST here.

(You are now in the car).

>sleep
Your mind begins to drift back to memories of you and your wife.

Driveway
Your driveway is immediately outside your garage. You don't really have time to go back inside.

To the north is the highway that you use to get to work everyday.

Your Camaro is nearby.

>get in car
Looks like a good place to get a quick break from today's events. You might try taking a quick REST here.

(You are now in the car).

>go n
Highway (in your car)
Full of cars. Calming, for once. North of here is your workplace; south is your driveway.

>go n
Workplace (in your car)
Here, you serve as a consultant for many top businesses in the area. You make enough to allow your wife to stay at home, but she has always mentioned wanting to go back to college for another degree.

You can see a mysterious figure here.

Your boss runs up to you as you pull into your parking space, a look of blank shock on his face.
You stare at him, confused, and open the door to step out and get your mind off of the argument you had this morning.

"Son, why in God's name are you here? Check your phone!"

You pre-emptively apologize, remembering that you left your phone in your cubicle, and inform your boss as such.

"Then I'm sorry to have to be the one to tell you this."
He pauses, uneasy at the message he is now being forced to deliver.

"Your wife's dead, son."
Your boss walks inside after giving you the weekend off. He glances sadly at you before walking back inside.
You begin to breathe rapidly. Thoughts flash through your mind. Why did you have to argue with your wife? Why does this seem so familiar? Why is he here?

>ask figure about phone
There is no reply.

>ask figure about work
There is no reply.

>ask figure about wife
There is no reply.

>ask figure about help
You could ask him about YOUR WIFE,HIMSELF, HELP, or THE STORY.

>ask figure about help
You won't get any from me.

>ask figure about your wife
I'm not responsible for how she dies, if that's what you're wondering.

>ask figure about himself
This is me. I'm talking to you. You don't need to know anything else.

>ask figure about the story
Very astute. Yes, you're in one. And it's not about you, no. But it is about YOU.
See you later. Or earlier. Take your pick; doesn't matter to me.
Here's your phone. Hold on to it. You might want it.
(You are now carrying the phone.)

    *** I'm sorry you had to find out this way. But, as you might suspect, I really have no control over it. You could try and go back, I suppose, but you might not find anything else worthwhile. ***

Would you like to RESTART, RESTORE a saved game, QUIT or UNDO the last command?

>restart
Interperter
An Interactive Fiction by Loquacious Libriform Computing
Release 1 / Serial number 151120 / Inform 7 build 6L38 (I6/v6.33 lib 6/12N) SD

Jones' Memorial Baptist
There is a crowd gathered here, mourning the loss of your wife.

There is a casket at the front of the room.

Outside is the parking lot, with your car and some well-deserved tranquility.
You feel a familiar vibration in your pocket.